11111111111111
1P00C0000C00E1
11111111111111